1111111111
10000P0001
10E00C0C01
10000E0001
1111111111
