1111111111
100P000001
10000E0001
1000C00001
1111111111
