1111111111111
1001000000111
1000011111101
100011EP00001
1111111111111
