11111111111
1P000E00C01
10000C00001
11111111111
