11111111111111111
1P000E000000C0C01
11000001111111101
11000001000000001
11C0000100000C001
110000010C0000001
11111111111111111
