1111111111111
1001000000111
10011111CC001
100011EP00001
1111111111111
