11111111111
100C0E000P1
10000000001
11111111111
