11111111111111111111
10000000C00000000001
11000C00000000000001
10000C000000000000P1
10000C000000010000E1
10000C00000000000001
10000C00000000000001
10000C00000000000001
10000C00000000000001
10000C00000000000001
10000C00000000000001
10000C00000000000001
10000C00000000000001
11111111111111111111
