11111111111111111111111111
10000000000000000000000001
1000C000000000000000000001
10000000000000000000000001
100000000000P000000000C001
10000000000000000000000001
10000000000000000000000001
1000C0000000000000000E0001
10000000000000000000000001
11111111111111111111111111
